##  ##      ####################################################################################
##  ##      ###      ########               ##                                                 #
                                              ##                                               #
                                                ##                                             #
       ##########                                  #                                           #
                                                                                               #
                    #########        ##################   ##############  ##################   #
                                                                               ##############  #
##*#   ###*#####     ###   ##########                                                          #
   *                                                                                           #
           **                                                                                  #
################################  ##############################################################
