##  ##      ####################################################################################
##  ##      ###      ########               ##                                                 #
                                              ##                                               #
                                                ##                                             #
       ##########                                  #                                           #
                                                                                               #
                    #########        ##################   ##############  ##################   #
                                                                               ##############  #
##*#   ###*#####     ###   ##########                                                          #
   *                                                                                           #
    M      **              M                       E                                           #
################################################################################################
