##  ##      ####################################################################################
##  ##      ###      ########               ##                                                 #
                                              ##                                               #
                                                ##                                             #
       ##########                                  #                                           #
                                                                                               #
#                   #########        ##################   ##############  ##################   #
#P                                                                             ##############  #
##*#   ###*#####     ###   ##########                                                          #
#  *                                                                                           #
#   M      **              M                       E                                           #
###############################  ###############################################################
